--A--AAAPPPPPPPA----
A------A^PPPPP^-___-
--PPP----PPPPPP-___-
--PPP--^^PPPPPPA___-
H-PCP----PPPPPP-----
c-----PPPPPPPPPcc---
A---ccPPPPPPPPPA-c--
-----HHAPPPPPPP^A---
-------A^PPPPPP^A---
--------APPPPPPA----
---------PPPPPP-----
-------PPPPPPPPP----
-------PPPPPPPPP----
--------PPPAPPP----A
-----AcccPPAA-P----A
----cc-AA------+----
---+------------+PPP
AAc-------------PPPP
Acc-------------PPPP