!!A!!AAAPPPPPPPA!!!!
A!!!!!!A^PPPPP^!___!
!!PPP!!!!PPPPPP!_x_!
!!PPP!!^^PPPPPPA___!
H!PCP!!!!PPPPPP!!!!x
c!!!!!PPPPPPPPPcc!!!
A!!!ccPPPPPPPPPAxc!x
!!!!!HHAPPPPPPP^Axx!
!!*!!!!A^PPPPPP^A!!x
!***!!!!APPPPPPA!!xx
*!*!*!!!!PPPPPP!!xxx
!*!*!!!PPPPPPPPP!!xx
!!!!!!!PPPPPPPPP!!!!
!!!!!!!!PPPAPPP!!!!A
!!!x!AcccPPAA!P!!!!A
!!!!cc!AA!!!!!!+!!!!
!x!+!x!!!!!!o!!!+PPP
AAc!!!!!x!!!!oo!PPPP
Acc!x!x!!!!!o!!!PPPP