~~~~~~~~~~~~~~~~~~~~~~~~~~~~~~~
~~~~~~~~~~___________~~~~~~~~~~
~~~~~~~________x________~~~~~~~
~~~~~____x____________x___~~~~~
~~~~W_____________________W~~~~
~~~_WW____x______________WW_~~~
~~~__WW____________x____WW__~~~
~~____WW_______________WW____~~
~~__e__WW_____________WW__e__~~
~~______W__|__________W______~~
~_______W_x________|__W_______~
~___x___W___W_____W___W___x___~
~_______W___W_____W___W_______~
~_______W___W_____W___W_______~
~_______W___W_____W_x_W_______~
~___________W_____W___________~
~_______W___W_____W___W_______~
~_______W___W__x__W___W_______~
~_______W___W_xex_W_|_W_______~
~___x___W___WWWWWWW___W___x___~
~_______W_____________W_______~
~~______W__x_______x__W______~~
~~__e__WW_____________WW__e__~~
~~____WW__|_________|__WW____~~
~~~__WW_________________WW__~~~
~~~_WW___________________WW_~~~
~~~~W__________*__________W~~~~
~~~~~_________*_*_________~~~~~
~~~~~~~______*_*_*______~~~~~~~
~~~~~~~~~~___________~~~~~~~~~~
~~~~~~~~~~~~~~~~~~~~~~~~~~~~~~~