____________
_____**_____
____________
_x__________
____________
____________
x________x__
__x_________
____________
x__x____x___
____xxx_____
____________