~~~~~~~~~~~~~~~~~~~~~~~~~~~~~~~
~~~~~~~~~~___________~~~~~~~~~~
~~~~~~~________T________~~~~~~~
~~~~~____|____________|___~~~~~
~~~~W_____________________W~~~~
~~~_WW___________________WW_~~~
~~~__WW_________________WW__~~~
~~____WW_______________WW____~~
~~__e__WW_____________WW__e__~~
~~______W__|__________W______~~
~_______W__________|__W_______~
~_______W___W_____W___W_______~
~_______W___W_____W___W_______~
~_______W___W_____W___W_______~
~_______W___W_____W___W_______~
~___________W_____W___________~
~_______W___W_____W___W_______~
~_______W___W__|__W___W_______~
~_______W___W_|e|_W_|_W_______~
~_______W___WWWWWWW___W_______~
~_______W_____________W_______~
~~______W_____________W______~~
~~__e__WW_____________WW__e__~~
~~____WW__|_________|__WW____~~
~~~__WW_________________WW__~~~
~~~_WW___________________WW_~~~
~~~~W_____________________W~~~~
~~~~~_____________________~~~~~
~~~~~~~_________________~~~~~~~
~~~~~~~~~~___________~~~~~~~~~~
~~~~~~~~~~~~~~~~~~~~~~~~~~~~~~~