____________
____________
_|________|_
________RR__
__R______R__
_RRR________
_|____RR__|_
______R_____
__R______RR_
_RR_______RR
_|R_______|_
_____rr_____